20 11
100 100
71 71 71 71 71 71 71 71 71 71 71 71 71 71 71 71 71 71 71 71 
71 35 35 35 35 71 35 35 35 35 35 35 35 71 35 35 35 71 35 71
71 35 35 35 35 71 35 71 35 71 35 71 35 71 35 71 35 71 35 71
71 35 35 35 35 71 35 71 35 71 35 71 35 71 35 35 35 71 35 71
71 35 35 35 35 35 35 35 35 71 35 71 35 71 35 71 35 71 35 71 
71 71 71 71 71 71 71 71 35 71 35 71 35 71 35 35 35 35 35 71
71 35 35 35 35 35 35 71 35 71 35 71 35 71 35 71 35 71 35 71
71 35 71 71 71 71 35 71 35 71 35 71 35 71 35 35 35 71 35 71 
71 35 71 71 71 71 35 71 71 71 71 71 35 35 35 71 35 71 35 71
71 35 35 35 35 35 35 35 35 35 35 35 35 35 35 35 35 71 59 71
71 71 71 71 71 71 71 71 71 71 71 71 71 71 71 71 71 71 71 71 
