30 30
100 100
39 45 45 45 67 44 44 44 44 44 44 44 44 44 44 44 44 44 44 44 44 44 44 44 44 44 44 44 44 67
40 53 53 48 40 48 53 48 48 48 48 48 48 53 48 48 48 48 48 53 53 53 48 48 48 48 48 48 48 40
64 44 48 48 40 48 42 44 44 44 44 44 44 44 44 67 44 44 44 44 44 44 44 44 44 44 44 48 48 40
40 48 48 48 40 48 48 48 48 53 48 53 48 53 53 40 48 48 48 48 48 53 48 48 53 48 48 48 41 40
40 48 64 45 68 45 45 45 45 45 46 48 48 39 48 40 53 42 44 44 44 44 44 44 44 67 44 48 48 40
40 48 40 48 53 48 48 48 48 53 48 48 48 40 48 40 48 48 53 48 48 48 53 53 48 40 48 48 41 40
40 48 40 48 64 44 44 44 44 44 44 44 44 65 48 42 44 44 67 44 67 44 44 44 44 69 48 48 48 40
40 48 48 48 40 48 53 53 53 48 48 48 48 48 53 53 53 48 40 48 40 48 48 53 53 53 48 48 41 40
40 48 39 48 40 53 53 42 44 44 44 67 44 44 44 44 44 44 69 48 40 48 48 53 53 40 48 48 48 40
40 53 40 48 40 48 48 48 53 53 53 40 48 48 48 53 53 53 48 48 42 44 44 44 44 69 48 48 41 40
64 45 65 48 42 45 45 45 45 46 48 64 44 44 44 65 53 40 48 48 48 53 48 48 53 48 48 48 48 40
40 48 48 53 48 48 48 53 48 53 48 40 48 48 53 53 53 40 48 39 48 48 48 64 44 44 44 48 48 40
40 48 64 44 44 44 44 67 44 44 44 44 44 44 44 44 44 69 48 42 44 44 53 40 48 53 48 48 53 40
40 53 40 48 53 53 48 40 48 53 53 48 48 53 53 48 48 53 53 53 48 48 48 40 48 44 67 53 53 40
40 53 40 53 64 44 44 69 53 42 44 44 44 44 44 44 44 44 44 44 44 44 44 66 48 53 40 48 48 40
40 48 40 48 40 48 48 53 53 53 48 48 48 53 53 53 53 48 48 53 53 53 48 42 44 48 40 53 53 40 
40 53 40 48 42 44 44 44 44 44 44 44 44 44 44 44 45 53 53 42 44 44 44 65 48 53 40 53 48 40
40 48 40 53 53 53 48 48 53 53 53 53 53 48 48 48 53 53 53 53 48 48 48 40 53 41 40 53 53 40
40 48 40 53 42 44 44 44 44 44 44 44 44 44 44 44 44 44 67 53 67 44 44 66 53 53 40 48 53 40
40 53 40 53 53 48 41 48 48 48 41 53 53 53 41 48 48 48 40 48 42 48 48 42 44 48 40 48 41 40
40 48 40 48 39 48 48 48 40 48 53 53 40 53 53 53 53 48 40 48 48 48 48 40 48 53 40 53 53 40
40 48 40 53 66 44 44 44 66 44 44 44 66 44 44 44 53 42 65 44 44 44 44 66 53 41 40 44 44 69
40 53 40 53 40 48 53 53 40 53 53 53 48 48 48 53 53 53 53 48 53 53 53 40 53 48 48 48 53 40
40 48 40 53 41 53 40 48 42 44 44 44 48 48 42 67 48 48 42 44 44 44 44 67 44 44 44 40 48 40
40 48 40 53 53 53 40 48 48 48 53 53 53 48 48 40 48 53 53 53 48 53 53 40 53 53 48 40 48 40
40 48 40 53 39 53 42 44 44 44 44 44 44 44 44 66 44 44 44 44 44 44 44 44 44 44 44 69 48 40
40 53 40 48 40 48 48 53 53 48 48 48 53 53 53 48 48 53 53 53 48 48 53 53 53 53 48 53 53 40
40 53 42 45 69 44 44 44 44 66 44 44 44 44 53 39 48 43 44 44 44 44 44 44 44 44 44 44 44 66
40 48 53 53 53 48 53 53 53 40 53 48 53 53 53 40 53 48 53 53 53 53 48 53 53 53 53 53 53 40
42 44 44 44 44 44 44 44 44 66 44 44 44 44 44 69 44 44 44 44 44 44 44 44 44 44 44 44 44 65