25 25 
60 60
71 71 71 71 71 71 71 71 71 71 71 71 71 71 71 71 71 71 71 71 71 71 71 71 71
71 35 71 35 35 35 35 35 35 35 35 35 35 35 35 35 35 35 35 35 71 35 35 35 35
71 35 71 35 71 71 71 71 71 71 71 71 71 71 71 35 71 71 71 35 71 35 71 35 71
71 35 35 35 71 35 71 35 35 35 35 35 35 35 35 35 71 35 71 35 71 35 71 35 71
71 35 71 71 71 35 71 35 71 71 71 71 71 71 71 71 71 35 71 35 71 35 71 35 71
71 35 35 35 71 35 71 35 71 35 35 35 35 35 35 35 35 35 71 35 71 35 71 35 71
71 71 71 35 71 35 71 35 71 35 71 35 71 35 71 71 71 71 71 35 71 35 71 35 71
71 35 71 35 71 35 71 35 71 35 35 35 35 35 35 35 35 35 35 35 71 35 71 35 71
71 35 71 35 71 35 71 35 71 71 71 71 71 71 71 71 71 71 71 71 71 35 35 35 71
71 35 71 35 71 35 35 35 35 35 35 35 35 35 35 35 35 35 35 35 35 35 35 35 71
71 35 71 35 71 35 35 35 35 71 71 71 71 71 71 71 71 71 71 71 71 71 71 71 71
71 35 35 35 71 71 71 71 35 71 35 35 35 35 35 35 35 35 35 35 71 35 35 35 71
71 35 71 35 35 35 35 71 35 71 35 71 71 71 71 71 71 71 71 35 71 71 71 35 71
71 35 71 71 71 71 35 71 35 71 35 71 35 71 35 35 35 35 35 35 71 35 35 35 71
71 35 35 35 35 71 35 71 35 71 35 71 35 71 71 71 71 71 35 35 71 35 71 35 71
71 35 71 71 35 71 71 71 35 71 35 71 35 35 35 35 35 71 35 35 71 35 71 35 71
71 35 71 71 35 35 35 71 35 71 35 71 35 71 71 71 71 71 35 35 71 35 71 35 71
71 71 71 71 71 71 35 71 35 71 35 71 35 35 35 35 35 35 35 35 71 35 71 35 71
71 35 71 35 35 35 35 71 35 71 35 71 35 71 71 71 71 71 71 71 71 35 71 35 71
71 35 71 35 71 71 71 71 71 71 35 71 35 71 35 35 35 35 35 35 35 35 71 35 71
71 35 71 35 35 35 35 35 35 71 35 71 35 71 35 35 35 71 71 71 71 71 71 35 71
71 35 71 71 71 71 71 35 35 71 35 71 71 71 35 35 35 71 35 35 35 35 71 35 71
71 35 35 35 35 35 35 35 35 35 35 35 35 35 35 71 71 71 35 61 35 35 71 35 71
71 35 71 35 71 35 71 35 71 35 71 35 71 35 71 71 35 35 35 35 35 35 35 35 71
71 71 71 71 71 71 71 71 71 71 71 71 71 71 71 71 71 71 71 71 71 71 71 71 71 





