30 30
100 100
39 45 45 45 67 44 44 44 44 44 44 44 44 44 44 44 44 44 44 44 44 44 44 44 44 44 44 44 44 67
40 35 35 35 40 35 35 35 35 35 35 35 35 35 35 35 35 35 35 35 35 35 35 35 35 35 35 35 35 40
64 44 35 35 40 35 42 44 44 44 44 44 44 44 44 67 44 44 44 44 44 44 44 44 44 44 44 35 35 40
40 35 35 35 40 35 35 35 35 35 35 35 35 35 35 40 35 35 35 35 35 35 35 35 35 35 35 35 41 40
40 35 64 45 68 45 45 45 45 45 46 35 35 39 35 40 35 42 44 44 44 44 44 44 44 67 44 35 35 40
40 35 40 35 35 35 35 35 35 35 35 35 35 40 35 40 35 35 35 35 35 35 35 35 35 40 35 35 41 40
40 35 40 35 64 44 44 44 44 44 44 44 44 65 35 42 44 44 67 44 67 44 44 44 44 69 35 35 35 40
40 35 35 35 40 35 35 35 35 35 35 35 35 35 35 35 35 35 40 35 40 35 35 35 35 35 35 35 41 40
40 35 39 35 40 35 35 42 44 44 44 67 44 44 44 44 44 44 69 35 40 35 35 35 35 40 35 35 35 40
40 35 40 35 40 35 35 35 35 35 35 40 35 35 35 35 35 35 35 35 42 44 44 44 44 69 35 35 41 40
64 45 65 35 42 45 45 45 45 46 35 64 44 44 44 65 35 40 35 35 35 35 35 35 35 35 35 35 35 40
40 35 35 35 35 35 35 35 35 35 35 40 35 35 35 35 35 40 35 39 35 35 35 64 44 44 44 35 35 40
40 35 64 44 44 44 44 67 44 44 44 44 44 44 44 44 44 69 35 42 44 44 35 40 35 35 35 35 35 40
40 35 40 35 35 35 35 40 35 35 35 35 35 35 35 35 35 35 35 35 35 35 35 40 35 44 67 35 35 40
40 35 40 35 64 44 44 69 35 42 44 44 44 44 44 44 44 44 44 44 44 44 44 66 35 35 40 35 35 40
40 35 40 35 40 35 35 35 35 35 35 35 35 35 35 35 35 35 35 35 35 35 35 42 44 35 40 35 35 40 
40 35 40 35 42 44 44 44 44 44 44 44 44 44 44 44 45 35 35 42 44 44 44 65 35 35 40 35 35 40
40 35 40 35 35 35 35 35 35 35 35 35 35 35 35 35 35 35 35 35 35 35 35 40 35 41 40 35 35 40
40 35 40 35 42 44 44 44 44 44 44 44 44 44 44 44 44 44 67 35 67 44 44 66 35 35 40 35 35 40
40 35 40 35 35 35 41 35 35 35 41 35 35 35 41 35 35 35 40 35 42 35 35 42 44 35 40 35 41 40
40 35 40 35 39 35 35 35 40 35 35 35 40 35 35 35 35 35 40 35 35 35 35 40 35 35 40 35 35 40
40 35 40 35 66 44 44 44 66 44 44 44 66 44 44 44 35 42 65 44 44 44 44 66 35 41 40 44 44 69
40 35 40 35 40 35 35 35 40 35 35 35 35 35 35 35 35 35 62 35 35 35 35 40 35 35 35 35 35 40
40 35 40 35 41 35 40 35 42 44 44 44 35 35 42 67 35 35 42 44 44 44 44 67 44 44 44 40 35 40
40 35 40 35 35 35 40 35 35 35 35 35 35 35 35 40 35 35 35 35 35 35 35 40 35 35 35 40 35 40
40 35 40 35 39 35 42 44 44 44 44 44 44 44 44 66 44 44 44 44 44 44 44 44 44 44 44 69 35 40
40 35 40 35 40 35 35 35 35 35 35 35 35 35 35 35 35 35 35 35 35 35 35 35 35 35 35 35 35 40
40 35 42 45 69 44 44 44 44 66 44 44 44 44 35 39 35 43 44 44 44 44 44 44 44 44 44 44 44 66
40 35 35 35 35 35 35 35 35 40 35 35 35 35 35 40 35 35 35 35 35 35 35 35 35 35 35 35 35 40
42 44 44 44 44 44 44 44 44 66 44 44 44 44 44 69 44 44 44 44 44 44 44 44 44 44 44 44 44 65