40 40
100 100
71 71 71 71 71 71 71 71 71 71 71 71 71 71 71 71 71 71 71 71 71 71 71 71 71 71 71 71 71 71 71 71 71 71 71 71 71 71 71 71
71 35 35 35 35 35 35 35 35 35 35 35 35 35 71 35 35 35 35 35 35 35 35 35 71 35 35 35 35 35 35 35 35 35 35 35 35 35 35 71
71 35 35 35 71 71 71 71 71 35 71 35 71 35 71 71 71 71 71 35 71 71 71 35 71 35 71 71 71 71 71 71 71 71 35 71 71 71 35 71
71 35 35 35 71 35 35 35 35 35 71 35 71 35 35 35 35 35 71 35 71 35 71 35 71 35 35 35 35 35 35 35 35 35 35 35 35 71 35 71
71 35 71 35 71 35 71 71 71 71 71 35 71 71 71 71 71 35 71 35 71 35 71 35 71 71 35 71 71 71 71 71 71 71 71 71 71 71 35 71
71 35 71 35 71 35 71 35 35 35 71 35 71 71 71 71 71 35 71 35 71 35 71 35 35 71 35 35 35 35 35 35 71 35 71 71 71 71 35 71  
71 35 71 35 71 35 71 35 71 35 71 35 35 35 35 35 71 35 35 35 71 35 71 35 35 71 71 71 71 71 71 35 71 35 35 35 35 71 35 71
71 35 71 35 71 35 71 35 71 35 71 71 71 35 71 35 71 35 71 71 71 35 71 35 71 71 71 71 71 35 35 35 71 35 35 71 35 71 35 71
71 35 71 35 71 35 71 35 71 35 35 35 71 35 71 35 71 35 71 35 35 35 71 35 35 35 35 35 35 35 71 35 71 35 35 71 35 71 71 71
71 35 71 35 71 35 71 35 71 35 71 71 71 35 71 35 35 35 71 35 71 35 71 35 71 35 71 71 71 35 71 35 71 35 35 71 35 35 35 71
71 35 71 35 71 35 71 35 71 35 35 35 35 35 71 35 71 71 71 35 71 35 71 35 71 35 71 35 35 35 71 35 71 35 35 71 71 71 35 71
71 35 71 35 71 35 71 35 71 35 71 71 71 71 71 35 71 35 35 35 71 35 35 35 71 35 71 35 35 35 71 35 71 35 35 35 35 71 35 71
71 35 71 71 71 35 71 35 71 35 71 35 35 35 35 35 71 35 71 71 71 35 71 35 71 35 71 35 35 35 71 35 71 35 35 35 35 71 35 71
71 35 71 35 35 35 71 35 71 35 71 35 71 71 71 71 71 35 71 35 35 35 71 35 71 35 71 35 71 71 71 71 71 71 71 35 35 71 35 71
71 35 71 71 71 71 71 35 71 35 71 35 35 35 35 35 35 35 71 35 71 71 71 35 71 35 35 35 71 35 35 35 35 35 35 35 35 71 35 71
71 35 35 71 35 35 35 35 71 35 71 35 71 35 71 71 71 35 71 35 71 35 35 35 71 71 71 35 71 35 71 71 71 71 35 71 71 71 35 71
71 35 35 71 35 71 71 35 71 35 71 35 71 35 35 35 71 35 71 35 71 35 71 35 35 35 71 35 71 35 71 35 35 35 35 71 35 35 35 71
71 35 35 71 35 71 35 35 35 35 35 35 71 35 71 35 71 35 71 35 71 35 71 71 71 35 71 35 71 35 71 35 71 35 35 71 35 35 63 71
71 35 35 71 35 71 35 71 71 71 71 71 71 71 71 35 71 35 35 35 71 35 35 35 71 35 71 35 71 35 71 35 71 35 35 71 35 35 35 71
71 35 35 71 35 71 35 35 35 35 35 35 35 35 35 35 71 35 71 35 71 35 35 35 71 35 35 35 71 35 71 35 71 35 35 71 71 71 35 71
71 35 35 35 35 71 35 71 71 71 71 71 35 71 71 35 71 35 71 35 71 35 71 71 71 35 71 35 71 35 71 35 71 71 35 35 35 71 35 71
71 35 71 71 71 71 35 71 35 35 35 71 35 71 35 35 71 35 71 35 71 35 71 35 35 35 71 35 71 35 71 35 35 71 35 35 35 71 35 71
71 35 71 35 35 35 35 71 35 71 35 71 35 71 35 71 71 35 71 35 71 35 71 35 71 71 71 35 71 35 71 71 71 71 71 71 71 71 35 71
71 35 71 35 71 71 71 71 35 71 35 71 35 71 35 71 35 35 71 35 71 35 71 35 71 35 35 35 71 35 35 35 35 35 35 35 35 71 35 71
71 35 71 35 71 35 35 35 35 71 35 35 35 71 35 71 35 35 71 35 71 35 71 35 71 35 71 71 71 35 71 71 71 35 71 71 71 71 35 71
71 35 71 35 71 35 71 71 71 71 35 71 35 71 35 71 35 71 71 35 71 35 71 35 71 35 71 35 35 35 35 35 71 35 71 35 35 71 35 71 
71 35 71 35 71 35 71 35 35 71 35 71 35 71 35 71 35 71 35 35 71 35 71 35 71 35 71 71 71 71 71 35 71 35 71 35 35 71 35 71 
71 35 71 35 35 35 71 35 35 71 35 71 35 71 35 35 35 35 35 35 71 35 35 35 71 35 35 35 35 35 71 35 71 35 35 35 35 71 35 71 
71 35 71 35 71 35 71 35 71 71 35 71 35 71 71 71 71 71 71 71 71 71 35 35 71 35 71 71 71 35 71 35 71 35 71 35 35 71 35 71 
71 35 71 35 71 35 71 35 71 35 35 71 35 35 35 35 35 35 35 35 35 71 35 35 35 35 71 35 71 35 71 35 71 35 71 35 71 71 35 71
71 35 71 35 71 35 71 35 71 35 35 35 35 35 35 35 35 35 71 71 35 71 71 71 71 35 71 35 71 35 71 35 71 35 71 35 71 35 35 71
71 35 71 35 71 35 71 35 71 35 71 71 71 71 71 71 71 35 71 35 35 35 35 35 71 71 71 35 71 35 71 35 71 35 71 35 71 35 35 71
71 35 71 35 71 35 71 35 71 35 35 35 35 35 35 35 71 35 71 35 71 71 71 35 35 35 35 35 71 35 71 35 71 35 71 35 71 35 35 71
71 35 71 35 35 35 35 35 71 71 71 71 71 71 71 35 71 35 71 35 71 35 35 35 71 71 71 71 71 35 35 35 35 35 35 35 71 35 71 71 
71 35 71 71 71 35 35 35 35 35 35 35 35 35 71 35 35 35 71 35 71 71 71 35 71 35 35 35 35 35 71 71 71 71 71 71 71 35 71 71
71 35 35 35 71 35 71 71 71 71 71 71 71 35 71 35 71 71 71 35 35 35 71 35 71 35 71 35 35 71 71 35 35 35 35 35 35 35 71 71 
71 35 71 71 71 35 35 35 35 35 35 35 71 35 71 35 71 35 35 35 35 35 71 35 71 35 71 35 35 71 35 35 35 71 71 71 71 71 71 71
71 35 71 71 71 71 71 71 71 71 71 71 71 35 71 35 71 71 71 71 71 71 71 35 71 35 71 71 71 71 35 71 71 71 35 35 35 35 35 71
71 35 35 35 35 35 35 35 35 35 35 35 35 35 71 35 71 35 35 35 35 35 35 35 35 35 71 35 35 35 35 35 35 35 35 35 35 35 35 71
71 71 71 71 71 71 71 71 71 71 71 71 71 71 71 71 71 71 71 71 71 71 71 71 71 71 71 71 71 71 71 71 71 71 71 71 71 71 71 71 
