20 20
100 100
71 71 71 71 71 71 71 71 71 71 71 71 71 71 71 71 71 71 71 71
71 35 35 35 35 35 35 35 35 35 35 35 35 35 71 35 35 35 35 71
71 35 35 35 71 71 71 71 71 71 71 71 71 35 71 35 71 35 35 71
71 35 35 35 35 35 35 35 35 35 35 35 71 35 71 35 71 35 35 71
71 35 71 71 71 71 71 71 35 71 71 71 71 35 71 71 71 35 71 71
71 35 71 35 71 35 35 35 35 35 35 35 35 35 35 35 71 35 71 71
71 35 71 35 71 35 35 35 35 35 35 35 35 35 35 35 71 35 71 71
71 35 71 35 71 35 71 71 71 71 71 71 71 71 71 35 71 35 71 71
71 35 71 35 71 35 71 35 35 35 35 35 35 35 35 35 35 35 71 71
71 35 71 35 71 35 71 71 71 71 71 35 71 71 71 71 71 71 71 71
71 35 71 35 71 35 35 35 35 35 71 35 71 35 35 35 35 35 35 71
71 35 71 35 71 35 71 71 71 71 71 35 71 71 71 35 71 35 35 71
71 35 35 35 71 35 71 35 35 35 35 35 35 35 71 35 71 35 35 71
71 71 71 71 71 35 71 71 35 71 71 71 71 35 71 71 71 35 35 71
71 71 71 71 71 35 71 71 35 71 71 71 71 35 35 35 35 35 35 71
71 71 71 71 71 71 35 71 35 71 60 60 71 71 71 71 71 71 35 71 
71 35 35 35 35 71 35 35 35 71 35 35 35 35 35 35 35 71 35 71
71 71 71 71 71 71 71 71 35 71 35 71 71 71 71 71 71 71 35 71
71 35 35 35 35 35 35 71 35 71 35 35 35 35 35 35 35 35 35 71
71 71 71 71 71 71 71 71 71 71 71 71 71 71 71 71 71 71 71 71